XXXXXXXXXXXXXXXXXXXXXXX
*******************X***
*XXXXXXXXX*XXX*XXX*X*X*
*****X***X***X***X*X*X*
XXXX*X*X*XXXXX*X*X*X*X*
*****X*X*X***X*X*X*X*X*
XXXXXX*X*X*X*XXX*X*XXX*
*******X*X*X*****X*****
XXXXXXXX*X*XXXXXXXXXXX*
*******X***X*X*********
XXXX*XXXXXXX*X*XXXXXXXX
*****X*********X***X***
*XXXXX*XXXXXXXXX*X*XXX*
*****************X*****
XXXXXXXXXXXXXXXXXXXXXXX
