XXXXXXXXXXXXXXXXXXXXXXX
*******X***X*********X*
XXXX*X*X*X*X*XXXXX*X*X*
*****X***X*X*X*X***X*X*
*XXXXXXXXXXX*X*X*XXX*X*
***************X***X***
XX*XXXXXXXXXXXXXXX*XXX*
*X*******X***X*****X*X*
*XXXXXXXXX*X*X*XXXXX*X*
*****X*****X*X***X*X***
XXXX*X*XXXXX*XXX*X*X*XX
***X*X*X***X*X***X*X***
*XXX*X*X*X*X*X*XXX*XXX*
*******X*X*****X*******
XXXXXXXXXXXXXXXXXXXXXXX
