XXXXXXXXXXXXXXXXXXXXXXX
*X*********X***********
*X*XXX*XXX*XXX*XXXXX*X*
*X*X*X*X*X***X*X***X*X*
*X*X*X*X*XXX*X*X*X*X*X*
*****X*X*****X*X*X***X*
XXXXXX*XXXXX*XXX*XXXXX*
*****X*X***X*X***X*X***
XXXX*X*X*X*X*X*XXX*X*XX
***X*X***X*X*X*X***X***
*XXX*XXXXX*X*X*X*XXXXX*
***X*X***X*X*X*X*****X*
*X*X*X*X*X*X*X*X*X*XXX*
*X*****X***X***X*X*****
XXXXXXXXXXXXXXXXXXXXXXX
