XXXXXXXXXXXXXXXXXXXXXXX
*********X*****X***X***
*X*XXXXX*X*XXX*X*X*XXX*
*X***X*****X*X***X*****
*XXX*XXXXXXX*XXXXXXXXX*
***X*******X*******X***
XXXXXX*XXX*X*XXX*X*X*XX
*****X*X***X*X*X*X*X*X*
XXXX*X*X*XXX*X*X*X*X*X*
*X***X*X*X***X*X*X*X*X*
*X*XXXXX*X*XXX*X*XXX*X*
***X*****X***X*X***X*X*
*XXXXX*XXXXX*X*XXX*X*X*
*******X*********X*****
XXXXXXXXXXXXXXXXXXXXXXX
