XXXXXXXXXXXXXXXXXXXXXXX
*****************X*****
*XXXXXXX*XXXXXXX*X*X*X*
*******X*X***X***X*X*X*
XX*XXXXX*X*X*X*XXX*X*X*
***X*****X*X*X***X*X*X*
XXXX*XXXXX*XXXXX*XXX*X*
*X***X*X*********X***X*
*X*XXX*X*XXXXXXXXX*XXX*
***X***X*X***X*******X*
XXXX*XXX*X*X*X*XXXXX*XX
***X*****X*X*******X***
*XXX*XXXXXXXXXXXXXXXXX*
***********************
