XXXXXXXXXXXXXXXXXXXXXXX
***X*******X***********
*X*XXXXX*X*X*X*XXXXXXX*
*X*******X*X*X***X*****
*XXXXXXXXX*XXXXX*X*XXXX
*X*******X*******X*****
*X*XXX*XXXXXXXXXXXXXXX*
*X***X*X*************X*
XXXX*X*X*XXXXX*XXXXXXX*
*X***X*X***X***X*******
*X*XXX*XXX*X*XXX*XXXXXX
*X***X***X*X***X***X***
*XXX*X*XXX*XXX*XXX*XXX*
*****X*******X*********
XXXXXXXXXXXXXXXXXXXXXXX
