XXXXXXXXXXXXXXXXXXXXXXX
***********X*****X*****
*X*XXXXXXX*X*XXX*XXX*X*
*X*X*****X***X*******X*
*XXX*XXX*XXX*XXXXXXXXX*
*******X***X*X*****X*X*
XXXXXXXXXX*XXX*XXX*X*X*
*X*******X*******X*X*X*
*X*XXXXX*XXXXXXXXX*X*X*
*X*****X*****X*****X*X*
*XXXXX*XXXXX*X*XXXXX*X*
***X***X***X***X*****X*
XX*X*XXX*XXXXXXX*X*XXX*
*****X***********X*****
XXXXXXXXXXXXXXXXXXXXXXX
