XXXXXXXXXXXXXXXXXXXXXXX
*********X*************
*XXXXXXX*XXXXXXX*XXXXX*
*X***********X***X***X*
*XXX*XXXXXXX*X*XXX*X*X*
***X***X***X***X***X*X*
XX*XXX*X*X*XXXXX*XXX*X*
*X***X*X*X*X***X***X***
*X*X*XXX*X*X*XXXXX*XXXX
*X*X*X***X*X*******X***
*XXX*X*XXX*X*XXXXXXXXX*
***X*****X*X*X***X***X*
XX*XXXXXXX*X*X*X*X*X*X*
***********X***X***X***
XXXXXXXXXXXXXXXXXXXXXXX
