XXXXXXXXXXXXXXXXXXXXXXX
***********X*X*******X*
*XXXXXXX*X*X*X*X*XXX*X*
*X***X***X*X***X*X*****
*X*X*X*XXX*X*XXX*XXXXX*
***X*X*X***X***X*****X*
XXXX*X*XXX*XXXXXXXXX*X*
*X*X*X***X*****X*****X*
*X*X*XXX*XXXXX*X*XXXXX*
*X***X***X***X*X*****X*
*XXXXX*XXX*XXX*XXXXX*XX
*******X***X***X***X***
XXXXXXXX*X*X*XXX*X*XXX*
*********X*******X*****
XXXXXXXXXXXXXXXXXXXXXXX
