XXXXXXXXXXXXXXXXXXXXXXX
*****X*********X*******
XX*X*X*XXXXXXX*XXX*XXXX
***X***X*****X***X*****
*XXXXX*X*XXXXXXX*X*XXX*
*****X*X*****X***X***X*
XXXX*XXX*XXX*X*XXXXXXX*
***X***X***X***X*******
XX*X*X*XXXXX*XXX*XXXXX*
*X*X*X*****X***X***X***
*X*XXXXXXX*XXX*X*X*X*XX
***X*****X***X*X*X*X***
*XXX*XXX*XXX*X*XXX*XXX*
*****X*******X*****X***
XXXXXXXXXXXXXXXXXXXXXXX
