XXXXXXXXXXXXXXXXXXXXXXX
*************X*****X***
XXXX*XXXXXXX*X*X*XXX*X*
***X***X*X***X*X*****X*
*X*XXX*X*X*XXX*XXXXXXX*
*X*X*X***X*****X***X***
*X*X*X*XXXXX*XXXXX*X*X*
*X*X***X***X*X*****X*X*
XX*XXXXX*X*X*XXX*X*X*X*
*X***X***X*X*****X*X*X*
*XXX*X*XXX*X*XXXXXXX*X*
***X*X*X*X*X*X*****X*X*
*X*X*X*X*X*XXX*XXX*X*X*
*X*****X*******X*****X*
XXXXXXXXXXXXXXXXXXXXXXX
