XXXXXXXXXXXXXXXXXXXXXXX
***X***X*****X*********
*X*X*X*X*XXX*X*XXXXX*X*
*X***X*X***X***X*****X*
*XXXXXXX*XXXXX*X*X*XXXX
*********X***X*X*X*X***
XXXXXX*XXX*X*X*X*XXX*X*
*****X*X***X*X*X*****X*
XXXX*XXX*XXX*XXXXXXXXX*
***X***X*X*X***X***X***
*XXXXX*X*X*XXX*X*X*X*X*
*****X***X***X*X*X*X*X*
*X*XXXXXXX*XXX*X*X*X*X*
*X***************X***X*
XXXXXXXXXXXXXXXXXXXXXXX
