XXXXXXXXXXXXXXXXXXXXXXX
***X*****X*************
*XXX*X*X*X*XXXXXXXXXXX*
*****X*X*X***X*X***X***
*XXXXX*X*XXX*X*X*X*X*XX
*X*****X*X***X***X*****
XX*XXXXX*X*XXXXXXXXXXXX
***X*X***X*************
XXXX*X*XXXXXXXXXXXXX*X*
***X***X*****X*****X*X*
*XXX*XXX*XXX*X*XXX*X*X*
*X***X***X***X*X***X*X*
*X*XXX*XXX*XXX*X*XXXXX*
*******X*******X*******
XXXXXXXXXXXXXXXXXXXXXXX
