XXXXXXXXXXXXXXXXXXXXXXX
*********X*************
*X*XXXXX*XXXXXXX*X*XXX*
*X***X*X***X***X*X***X*
XXXX*X*XXX*X*X*XXXXX*X*
*****X***X*X*X*X***X*X*
*XXXXX*X*X*X*X*X*X*X*XX
*X*****X*X***X*X*X*X***
XX*XXXXXXXXXXX*X*X*XXX*
*********X***X***X***X*
*XXXXXXX*X*X*XXXXXXX*X*
*X*****X***X*X*****X***
*X*XXX*XXXXX*X*XXX*XXX*
***X*******X*****X*****
XXXXXXXXXXXXXXXXXXXXXXX
