XXXXXXXXXXXXXXXXXXXXXXX
***X*************X*****
*XXX*XXXXXXX*XXX*XXX*X*
***********X*X***X***X*
*XXXXXXXXX*X*X*XXX*XXXX
***X***X***X*X*X*******
XXXX*X*XXXXX*X*XXXXX*X*
*****X*******X***X*X*X*
XXXXXXXXXXXXXXXX*X*X*X*
*********X*****X*X***X*
*XXXXXXXXX*XXX*X*XXXXX*
*X*****X***X*X***X*****
*X*XXX*X*XXX*XXXXX*XXX*
*****X*************X***
XXXXXXXXXXXXXXXXXXXXXXX
