XXXXXXXXXXXXXXXXXXXXXXX
*******X*X*******X***X*
XX*XXX*X*X*X*XXX*X*X*X*
***X*X*X*X*X***X***X***
*XXX*X*X*X*XXX*XXXXXXX*
*X***X*X*****X*****X***
*XXX*X*XXXXXXXXXXX*XXXX
*X***X***********X*****
XX*XXXXXXXXXXXXX*XXX*X*
*X*******X*****X***X*X*
*X*XXX*XXX*X*XXXXX*XXX*
*X*X***X***X*****X*****
*X*X*XXX*XXXXXXX*XXXXX*
***X***********X*******
XXXXXXXXXXXXXXXXXXXXXXX
