XXXXXXXXXXXXXXXXXXXXXXX
***********************
*XXXXX*XXXXXXXXXXXXXXX*
*****X*X*****X***X*****
*XXX*XXX*XXX*X*X*XXX*XX
***X*******X***X***X***
XX*XXXXXXX*XXXXXXX*XXXX
*X***X***X*******X*****
*XXXXX*X*XXXXX*XXXXX*X*
*****X*X*X*****X***X*X*
XXXX*X*X*X*XXXXX*X*XXX*
*****X*X*X*****X*X***X*
*XXXXX*X*XXXXXXX*XXX*X*
*******X*********X*****
XXXXXXXXXXXXXXXXXXXXXXX
