XXXXXXXXXXXXXXXXXXXXXXX
*********X*****X*******
XXXX*XXX*XXX*X*X*XXXXX*
*****X*X***X*X***X*****
*XXXXX*XXX*X*XXXXX*XXX*
***X***X***X***X***X***
XX*X*XXX*XXXXXXX*XXX*XX
***X***X*****X***X***X*
XXXX*X*XXXXX*X*XXX*XXX*
***X*X*******X*X*X*X***
*X*X*XXXXXXXXX*X*X*X*X*
*X***X*********X*X*X*X*
*XXXXX*XXXXXXXXX*X*XXX*
*******X***************
XXXXXXXXXXXXXXXXXXXXXXX
