XXXXXXXXXXXXXXXXXXXXXXX
*********X***X*********
*XXXXXXX*X*X*XXX*XXXXX*
*X*X*****X*X*****X*****
*X*X*XXXXX*XXXXXXX*XXXX
*X***X***X*******X*X***
*X*XXX*X*X*XXXXX*X*XXX*
*X***X*X*******X*X*****
XXXX*XXXXXXXXX*X*XXXXX*
***X*********X*X*X*****
*XXXXXXXXXXX*XXX*X*XXXX
*****X***X***X***X*X***
*X*XXX*X*X*XXX*XXX*X*X*
*X*****X*******X*****X*
XXXXXXXXXXXXXXXXXXXXXXX
