XXXXXXXXXXXXXXXXXXXXXXX
*X*******X*****X*******
*X*XXX*XXX*XXX*X*XXX*X*
*X*X*X*****X***X*X***X*
*X*X*XXXXXXX*XXX*X*XXXX
*****X*X***X*****X*X***
XXXX*X*X*X*X*XXXXX*X*X*
***X***X*X*X*X***X***X*
XX*XXXXX*X*X*X*XXXXXXX*
*X*******X*X***X*****X*
*XXXXXXXXX*XXXXX*XXX*X*
*****X*****X***X***X***
*XXXXX*XXXXX*X*XXX*XXX*
*************X*****X***
XXXXXXXXXXXXXXXXXXXXXXX
