XXXXXXXXXXXXXXXXXXXXXXX
*********X*******X*****
XXXX*X*X*XXX*XXX*XXXXX*
***X*X*X*****X***X*****
*X*XXX*XXXXXXX*XXX*XXX*
*X*****X*****X*X***X*X*
*XXXXXXX*XXXXX*XXX*X*X*
*X*******X*****X***X***
XX*XXXXXXX*XXXXX*XXXXX*
*X***X***X*X***X*****X*
*X*X*X*X*X*X*X*XXXXX*X*
***X*X*X***X*X*******X*
*XXX*X*XXXXX*XXXXXXXXX*
***X*********X*********
XXXXXXXXXXXXXXXXXXXXXXX
