XXXXXXXXXXXXXXXXXXXXXXX
*****X***X*************
XX*X*X*XXX*XXXXX*XXXXXX
***X*X*****X*X***X*****
*XXX*X*XXXXX*X*XXX*XXX*
***X*X***X***X*****X***
XX*X*XXX*X*X*XXXXXXX*XX
***X***X***X*******X***
XXXXXX*XXX*XXXXXXX*XXX*
*****X*X***X*****X***X*
*XXX*X*XXXXX*XXX*XXXXX*
*X***X*******X*X*****X*
*XXXXXXXXXXXXX*XXXXX*X*
***********************
XXXXXXXXXXXXXXXXXXXXXXX
