XXXXXXXXXXXXXXXXXXXXXXX
*X*************X*******
*X*XXX*XXXXXXX*XXXXX*X*
***X***X***X***X*****X*
XXXX*XXX*X*X*XXX*XXXXX*
***X***X*X*X*X***X***X*
*X*XXX*X*XXX*X*XXX*X*X*
*X*****X***X*X*****X*X*
XXXXXXXX*X*X*X*XXXXX*X*
*X*****X*X***X*X*****X*
*X*XXX*X*XXXXX*X*XXXXXX
*X***X*X***X***X*******
*XXX*X*XXX*XXXXXXXXXXX*
*****X*****************
XXXXXXXXXXXXXXXXXXXXXXX
