XXXXXXXXXXXXXXXXXXXXXXX
***************X*******
*XXX*XXXXXXXXX*X*XXXXX*
***X***X*****X*X*X*****
XXXX*X*XXXXX*X*X*X*XXXX
***X*X*X***X***X*X*****
*X*XXX*X*X*XXX*X*XXXXX*
*X***X*X*X***X***X***X*
XXXX*X*X*XXX*XXXXX*XXX*
***X*X***X***X*X*******
*X*X*XXXXX*XXX*X*XXXXXX
*X*X*****X***X***X***X*
*XXXXXXX*XXX*X*XXX*X*X*
*************X*****X***
XXXXXXXXXXXXXXXXXXXXXXX
