XXXXXXXXXXXXXXXXXXXXXXX
***X***********X*******
*X*X*XXXXXXXXX*XXXXXXX*
*X***X***X***X*******X*
*XXXXX*X*X*XXXXXXXXX*X*
*X*****X*X*X*******X***
*X*XXX*X*X*X*XXXXX*XXX*
*X*X***X***X*X***X***X*
*X*X*XXXXX*X*X*XXX*X*X*
*X*X*******X*X***X*X***
XX*XXXXXXX*X*XXX*X*XXXX
*X*****X***X***X*X*****
*X*XXX*X*XXXXX*X*XXXXX*
*X***X*****X*X*X*******
XXXXXXXXXXXXXXXXXXXXXXX