XXXXXXXXXXXXXXXXXXXXXXX
***X***X*****X*********
*X*X*X*X*X*X*XXX*XXXXX*
*X*X*X***X*X*****X***X*
*X*XXXXX*X*XXXXXXX*XXX*
*X*****X*X***X*********
*XXXXX*X*XXX*XXXXXXX*XX
*X***X*X***X*****X*X***
XXXX*X*XXXXXXXXX*X*XXX*
*****X***********X***X*
*X*X*XXXXXXXXXXXXX*X*X*
*X*X*X*****X*******X*X*
*X*XXX*XXX*X*X*XXXXXXX*
*X*******X***X*********
XXXXXXXXXXXXXXXXXXXXXXX
