XXXXXXXXXXXXXXXXXXXXXXX
***********X***********
*X*XXXXXXX*XXXXX*XXX*X*
*X*X***X***X***X***X*X*
*X*X*X*X*XXX*X*XXX*X*XX
*X*X*X*X*****X***X*X***
XX*X*XXXXXXXXXXX*X*XXX*
***X*****X*****X*X***X*
XXXX*X*XXX*X*X*X*XXXXX*
***X*X*X***X*X*X*****X*
*XXX*X*X*XXX*XXXXXXX*X*
***X*X***X*X***X***X***
*X*X*XXXXX*XXX*X*X*XXX*
*X***********X***X*****
XXXXXXXXXXXXXXXXXXXXXXX
