XXXXXXXXXXXXXXXXXXXXXXX
***X***X*X*************
*X*X*X*X*X*XXXXXXXXXXX*
*X***X*X***X*****X*X***
*XXXXX*XXX*XXX*X*X*X*X*
*****X***X*****X***X*X*
XX*X*XXX*XXXXXXXXX*X*XX
*X*X*X*X***X*****X*X***
*X*X*X*XXX*X*XXX*X*XXX*
*X*X*X***X*X*X*X*X*X*X*
*XXX*X*X*X*X*X*X*X*X*X*
***X*X*X*X***X*X*X***X*
XX*X*X*X*XXXXX*X*XXXXX*
*****X*X***************
XXXXXXXXXXXXXXXXXXXXXXX
