XXXXXXXXXXXXXXXXXXXXXXX
*****X*****************
*X*XXX*XXXXX*XXXXXXXXX*
*X*X***X***X*X***X***X*
*X*X*XXXXX*X*X*XXX*X*X*
*X*X*******X*X***X*X***
XX*XXXXXXX*X*XXX*X*XXXX
*X*****X***X***X*X*****
*X*XXX*X*XXXXX*X*XXXXX*
*X***X*****X*X*X*******
*X*XXXXXXX*X*X*X*XXXXXX
*X*X*****X***X*X***X***
*XXX*XXX*XXXXX*XXX*X*X*
*****X*********X*****X*
XXXXXXXXXXXXXXXXXXXXXXX