XXXXXXXXXXXXXXXXXXXXXXX
*****X***********X*****
*XXX*X*XXX*XXXXX*XXX*X*
***X*****X*X***X***X*X*
*XXXXXXXXX*X*XXXXX*X*X*
*X*********X*****X***X*
XX*XXXXXXXXX*XXX*XXXXX*
*X*X***X***X*X*X*X***X*
*X*X*X*X*X*X*X*X*X*X*X*
***X*X***X***X*X***X***
XXXX*XXXXXXXXX*XXXXXXXX
***X***X*******X***X***
*X*XXX*XXX*XXX*X*X*XXX*
*X*********X*****X*****
XXXXXXXXXXXXXXXXXXXXXXX
