XXXXXXXXXXXXXXXXXXXXXXX
*********X*****X*******
*XXXXX*X*XXX*X*XXX*XXXX
*X***X*X*****X***X*****
*XXX*X*XXXXXXXXX*XXXXX*
*****X*X***X*****X*****
XXXX*X*XXX*X*XXXXX*XXX*
***X*X*X***X*******X***
XX*XXX*X*XXXXXXXXXXX*XX
*X*X***X*****X*******X*
*X*X*XXXXXXX*X*XXXXXXX*
***X*****X***X***X*****
*XXXXXXX*X*XXXXX*X*XXX*
*********X*********X***
XXXXXXXXXXXXXXXXXXXXXXX
