XXXXXXXXXXXXXXXXXXXXXXX
***********X***********
XXXXXXXX*X*X*XXXXX*XXX*
***X***X*X*X*****X*X*X*
*X*X*X*X*X*XXX*XXX*X*X*
*X***X*X*X*****X***X***
*XXXXX*X*XXXXXXX*XXXXXX
*X***X*X*X***X***X*****
XX*XXX*X*X*X*X*XXX*XXX*
***X***X***X*X*****X*X*
XX*X*XXX*XXXXXXX*XXX*X*
***X***X*X*****X*****X*
*XXXXX*XXX*XXX*XXXXXXX*
***********X***********
XXXXXXXXXXXXXXXXXXXXXXX
