XXXXXXXXXXXXXXXXXXXXXXX
*******X*****X*X*******
XXXX*X*X*XXX*X*X*XXX*XX
*****X***X***X***X*X***
*XXXXXXXXX*XXXXX*X*XXX*
***X*****X*****X***X***
XX*X*X*X*XXXXX*XXXXX*X*
*X*X*X*X*X***X*X*****X*
*X*XXX*X*X*X*X*X*XXXXX*
***X***X*X*X***X*X***X*
XXXX*XXXXX*XXXXX*X*XXX*
***X***X***X*****X*X***
*X*X*X*X*XXX*XXXXX*X*XX
*X***X*******X*********
XXXXXXXXXXXXXXXXXXXXXXX
