XXXXXXXXXXXXXXXXXXXXXXX
***********X*******X***
*X*XXXXXXX*XXX*XXX*X*X*
*X*X*****X***X*X***X*X*
XX*X*X*X*XXX*X*X*XXX*XX
***X*X*X***X***X*X*****
*XXXXX*XXXXXXXXX*X*XXX*
*X*****X*******X*X***X*
XX*XXXXX*XXXXX*X*XXXXX*
*X*****X*X*****X*X***X*
*X*XXX*X*X*XXX*X*X*X*X*
***X*X***X*X***X***X*X*
*XXX*XXXXX*XXXXXXXXX*X*
*********X*************
XXXXXXXXXXXXXXXXXXXXXXX
