XXXXXXXXXXXXXXXXXXXXXXX
*****X*************X***
*XXX*X*XXX*XXXXXXX*X*X*
***X*X*X*X*X*****X***X*
XX*X*X*X*X*X*XXXXXXXXX*
***X*X*X*X*X*********X*
*XXX*X*X*X*XXX*X*XXXXX*
*X*X*X***X***X*X*X*****
XX*X*XXXXXXX*X*X*X*XXXX
*X***X*****X*X*X*X*X***
*X*XXX*XXX*X*X*X*X*X*XX
*X*X***X*X***X*X*X*X***
*X*XXX*X*XXXXX*X*X*XXX*
*******X*******X*******
XXXXXXXXXXXXXXXXXXXXXXX
