XXXXXXXXXXXXXXXXXXXXXXX
*****X*********X*****X*
*X*X*XXXXXXX*X*X*XXX*X*
*X*X*********X***X*X*X*
XX*XXXXXXXXXXXXXXX*X*X*
***X*****X*****X*****X*
*XXX*X*XXX*XXX*X*XXXXX*
*X***X*X***X*X*X*X*****
XX*XXXXX*XXX*X*X*X*XXX*
*****X***X***X*X*X***X*
*XXX*X*XXX*X*X*X*XXXXX*
*X*X*X***X*X*X***X***X*
*X*X*XXX*X*X*XXXXX*X*X*
***X*******X*******X***
XXXXXXXXXXXXXXXXXXXXXXX
