XXXXXXXXXXXXXXXXXXXXXXX
*X*********X*****X*****
*X*X*XXXXX*XXXXX*X*XXX*
***X*X*****X***X***X***
*XXX*X*XXXXX*X*X*XXX*X*
***X*X*X*****X*X*X***X*
XXXX*X*XXXXX*X*XXX*XXX*
*****X***X***X***X***X*
XXXXXXXX*X*XXXXX*XXX*X*
*******X*X*X*****X***X*
*XXX*X*X*X*X*XXXXX*XXXX
*X***X*X*X*X*****X*****
*X*XXXXX*X*XXXXX*XXXXX*
*X*********X***********
XXXXXXXXXXXXXXXXXXXXXXX
