XXXXXXXXXXXXXXXXXXXXXXX
*******X***X*****X*****
XXXX*X*X*X*X*XXX*XXXXX*
*****X*X*X***X*********
*XXXXX*X*XXXXX*XXXXXXX*
*****X*X*X*****X***X***
XXXX*X*X*XXXXXXX*X*X*XX
*X***X*X*X*****X*X*X***
*X*XXX*X*X*XXX*X*X*XXX*
***X*X*X*****X***X*X***
XXXX*X*X*XXXXXXX*X*XXXX
***X***X*X*****X*X*****
*XXX*XXXXX*XXX*XXXXXXX*
***********X***********
XXXXXXXXXXXXXXXXXXXXXXX
