XXXXXXXXXXXXXXXXXXXXXXX
*******X***********X***
*X*XXXXX*XXXXX*XXX*X*X*
*X***X*****X***X*X***X*
*XXX*X*XXXXX*XXX*X*XXXX
*X***X*X*X***X*****X***
XX*XXX*X*X*XXX*XXXXX*X*
*X***X***X*X***X***X*X*
*XXX*XXX*X*XXXXX*X*X*X*
***X***X*X*******X***X*
XX*X*XXX*XXXXXXXXXXXXX*
***X*******X*********X*
*XXXXXXXXXXX*XXXXXXX*X*
*************X*********
XXXXXXXXXXXXXXXXXXXXXXX
