XXXXXXXXXXXXXXXXXXXXXXX
***X***********X*******
*X*X*XXXXXXXXX*XXXXXXX*
*X***X***X***X*******X*
*XXXXX*X*X*XXXXXXXXX*X*
*X*****X*X*X*******X***
*X*XXX*X*X*X*XXXXX*XXX*
*X*X***X***X*X***X***X*
XX*X*XXXXXXX*X*XXX*XXX*
*X*X*********X*X***X***
*X*XXXXXXXXXXX*X*X*X*XX
***X***********X*X*X***
*XXX*XXXXXXXXX*X*XXXXX*
*****X*********X*******
XXXXXXXXXXXXXXXXXXXXXXX
