XXXXXXXXXXXXXXXXXXXXXXX
***X*****X***********X*
XX*X*X*X*XXXXX*XXXXX*X*
***X*X*X*X***X*X***X***
*XXX*X*X*X*X*X*XXX*XXX*
*****X*X***X*X***X*****
XXXX*X*XXXXX*XXX*X*XXXX
***X*X*X***X*****X***X*
XX*X*X*XXX*XXXXXXXXX*X*
*X*X*X***X*******X***X*
*X*XXXXX*X*XXX*XXX*XXX*
***X*****X*X*X*****X***
*XXX*XXXXX*X*XXXXXXXXX*
*****X*****************
XXXXXXXXXXXXXXXXXXXXXXX
