XXXXXXXXXXXXXXXXXXXXXXX
*X*************X***X***
*X*X*XXXXXXXXX*X*X*XXX*
***X*X*****X***X*X*****
*XXX*X*XXX*X*XXX*XXXXX*
***X*X***X*X*X*****X*X*
XXXX*XXX*XXX*X*XXX*X*X*
*****X***X***X*X***X***
XXXXXX*XXX*XXXXX*XXX*XX
***X***X***X*****X***X*
*X*X*X*X*XXX*X*XXX*XXX*
*X*X*X*X*X***X*X*X***X*
*XXX*X*X*XXXXX*X*XXX*X*
*****X*********X*******
XXXXXXXXXXXXXXXXXXXXXXX
